NO ./textures/NO.xpm
SO ./textures/SO.xpm
WE ./textures/WE.xpm
EA ./textures/EA.xpm

F 20,100,0
C 225,30,0

11111111
10000001
10S00001
10000001
10001001
10001001
10001001
11111111