NO ./textures/north_texture
SO ./textures/south_texture
WE ./textures/west_texture
EA ./textures/east_texture

F 220,100,0
C 225,30,100

11111
10001
101N1
10001
1111
