NO ./assets/bluestone.xpm
SO ./assets/eagle.xpm
WE ./assets/greystone.xpm
EA ./assets/redbrick.xpm

F 0,0,0
C 225,225,225

        1111111111111111111111111
        1000000000110000000000001
        1011000001110000000000001
        1001000000000000000000001
111111111011000001110000000000001
100000000011000001110111100011111
11110111111111011100000010001
11110111111111011101010010001
11000000110101011100000010001
100000000000000011000000100011111
100000000000000011010100100000011
11000001110101011111011110S0111111
11110111 1110101 10111101000000001
11111111 1111111 11111111111111111