NO ./assets/bluestone.xpm
SO ./assets/eagle.xpm
WE ./assets/greystone.xpm
EA ./assets/redbrick.xpm

F 0, 0, 0
C 0, 255, 255

1111111111111111111111111
1000000000110000000000001
1011000001110000001000001
1001000000000000000000001
1111110111111101111111111
1000000000000000000000001
1000000000000000000000001
10000111000001110S0000001
1000000000000000000000001
1111111110111101111111111
1000000000110000000000001
1000000000110000000000001
1000000000000000000000001
1111111111111111111111111