NO ./assets/eagle.xpm
SO ./assets/eagle.xpm
WE ./assets/eagle.xpm
EA ./assets/eagle.xpm

F 20,100,0
C 225,30,0

11111111
1S000001
10000001
10000001
10001001
10001001
10001001
11111111
