NO ./textures/north_texture
SO ./textures/south_texture
WE ./textures/west_texture
EA ./textures/east_texture

F 220,100,0
C 225,30,100

11111111111111
10000000000001
10000000000001
1000111111111111111
101N100000000000001
1000000000000000001
1111111111111111111